9,9,9,9,9,9,9,9,9,9,9,9,9,9,9,9,9,9,9,9,9,9,9,9,9,9,9,9,9,9,
9,84,85,84,85,84,84,84,84,84,85,84,84,84,84,84,9,84,84,84,84,407,408,84,84,84,84,84,85,9,
9,109,110,109,110,109,109,109,109,109,110,109,109,109,109,109,9,109,109,109,109,432,433,109,109,109,368,109,110,9,
9,335,334,335,334,335,334,335,334,335,334,335,334,335,334,335,9,335,334,335,334,335,334,335,334,335,393,335,334,9,
9,360,336,360,9,360,359,360,359,360,359,360,359,360,359,360,9,360,359,360,359,360,359,360,359,360,359,360,359,9,
9,385,384,385,9,385,384,385,384,385,384,385,384,385,384,385,9,9,9,9,9,9,9,9,9,9,9,9,384,9,
9,405,405,405,9,335,334,335,334,335,334,335,334,335,334,335,334,335,334,335,334,335,334,335,334,335,334,335,334,9,
9,430,430,430,9,360,359,360,359,360,359,360,359,360,359,360,359,360,359,360,359,360,359,360,359,360,359,360,359,9,
9,9,9,9,9,385,384,385,384,385,384,385,384,385,384,385,384,385,384,385,384,385,384,385,384,385,384,385,384,9,
9,109,109,109,110,335,334,335,334,335,334,335,334,335,334,335,334,335,334,335,334,335,334,335,334,335,334,335,334,9,
9,360,359,360,359,360,359,360,359,360,359,360,359,360,359,360,359,360,359,360,359,360,359,360,359,360,359,360,359,9,
9,385,384,385,384,385,384,385,384,385,384,385,384,385,384,385,384,385,384,385,384,385,384,385,384,385,384,385,384,9,
9,404,334,335,334,335,334,335,334,335,334,335,334,335,334,335,334,335,334,335,334,335,334,335,334,335,334,335,334,9,
9,429,359,9,9,9,9,9,359,9,9,9,9,9,9,9,9,9,9,9,9,9,9,9,9,9,9,9,359,9,
9,385,384,337,338,109,110,9,384,9,337,338,109,110,109,110,340,390,365,109,110,101,102,103,101,102,103,110,384,9,
9,335,334,362,363,335,334,9,334,9,362,363,334,335,334,335,391,391,391,335,334,126,127,128,126,127,128,335,334,9,
9,360,359,387,388,360,359,9,359,9,387,388,359,360,359,360,359,360,359,360,359,360,359,360,359,360,359,360,359,9,
9,385,384,385,384,385,384,9,384,9,384,385,384,385,384,385,384,385,384,385,384,385,384,385,384,385,384,385,384,9,
9,335,334,335,334,335,334,9,334,9,334,335,334,335,334,335,334,335,334,335,334,335,334,335,334,335,334,335,334,9,
9,360,359,360,359,360,359,9,359,9,359,360,359,360,359,360,359,360,359,360,359,360,359,360,359,360,359,360,359,9,
9,385,384,385,384,385,384,9,384,9,384,385,384,385,384,385,384,385,384,385,384,385,384,385,384,385,384,385,384,9,
9,335,334,335,360,335,334,9,334,9,334,335,334,335,334,335,334,335,334,335,334,335,334,335,9,9,9,9,9,9,
9,360,359,360,9,360,359,9,359,9,359,360,359,360,359,360,359,360,359,360,359,360,359,360,109,109,109,109,109,9,
9,385,384,385,9,385,406,9,384,9,384,385,384,385,384,385,384,385,384,385,384,385,384,385,384,385,384,385,384,9,
9,335,334,335,9,335,431,9,334,244,270,270,270,270,270,270,270,270,270,270,270,270,270,270,270,270,270,270,270,9,
9,9,9,9,9,9,9,9,359,319,320,320,320,320,320,320,320,320,320,320,320,320,320,320,320,320,320,320,320,9,
9,109,110,109,110,109,109,110,384,385,384,385,384,385,384,385,334,385,384,385,384,385,384,385,384,385,384,385,384,9,
9,335,334,335,334,335,334,335,334,335,334,335,334,335,334,335,334,335,334,335,334,335,334,335,334,335,334,335,334,9,
9,360,359,360,359,360,359,360,359,360,359,360,359,360,359,360,359,360,359,360,359,360,359,360,359,360,359,360,359,9,
9,9,9,9,9,9,9,9,9,9,9,9,9,9,9,9,9,9,9,9,9,9,9,9,9,9,9,9,9,9

